EZO = "countries/Ezo.txt"
RYU = "countries/Ryukyu.txt"
KAB = "countries/Kalbar.txt"
JAY = "countries/Irian Jaya.txt"
BAL = "countries/Baluchistan.txt"
PAT = "countries/Patani.txt"
BOU = "countries/Bourgogne.txt"
SAR = "countries/Sardegna.txt"
DDN = "countries/Normandie.txt"
ALL = "countries/Alsace-Lorraine.txt"
GAS = "countries/Gascogne.txt"
VNZ = "countries/Venezia.txt"
SIC = "countries/Due Sicilie.txt"
TIR = "countries/Tirol.txt"
ATA = "countries/Asturies.txt"
LEO = "countries/Leon.txt"
ADC = "countries/Andalucia.txt"
EXT = "countries/Extremadura.txt"
FLA = "countries/Flandre.txt"
NUN = "countries/Nunaat.txt"
CAL = "countries/California.txt"
SOA = "countries/Alaska.txt"
SOW = "countries/Wisconsin.txt"
TEX = "countries/Texas.txt"
QUE = "countries/Quebec.txt"
IRO = "countries/Iroquois.txt"
SOO = "countries/Soomaaliland.txt"
BUC = "countries/Bucovina.txt"
OBE = "countries/Oberosterreich .txt"
VOR = "countries/Vorarlberg.txt"
KNN = "countries/Karnten.txt"
STE = "countries/Steiermark .txt"
SAL = "countries/Salzburg.txt"
KOS = "countries/Kosovo.txt"